!!!!!!!!!!!!
!..!!!!!!...
!...........
!....p..!!..
!....!!!....
!.......!!!!
!...!.......
!..!!!......
!...........
!!!!!!!!!!!!